11111111111111111
1P010000000C00001
10C10001000000001
10010001000C10001
10000111110010001
100011000000100C1
10010000011111111
1001C0000C0000001
1C01E00000C000011
11111111111111111