11111111111111111111111
1P010000000C00001100C01
10010000000000001100E01
10010000000010000110001
1000C000000010000000001
10001100000010000000001
10010000011111111111111
10C10000000C00000001111
10010000000001110000001
11111111111111111111111